########################################################################################################################################################
#                                                                                                                                                      E
#                                                                                                                                                      #
#                                                                                                                                                      #
#                                                                                                                                                      #
#                                                                                                                                                      #
#                                                                                                                                                      #
#                                                                                                                                                      #
#                                                                                                                                                      #
#                     ##################################################################################################################################
#                                                                                                                                                      #
#                                                                                                                                                      #
#                                                                                                                                                      #
#                                                                                                                                                      #
#                                                                                                                                                      #
###############################################################################################                                                        #
#                                                                                                                                                      #
#                     ##################################################################################################################################
#                                                                                                                                                      #
#                                                                                                                                                      #
#                                                                                                                                                      #
#                                                                                                                                                      #
#                                                                                                                                                      #
#                                                                                                                                                      #
#                                                                                                                                                      #
#                                                                                                                                                      #
#                                                                                                                                                      #
#                                                                                                                                                      #
#                                                                                                                                                      #
#                                                                                                                                                      #
################################################################################################                                                       #
#                                                                                                                                                      #
#                                                                                                                                                      #
#                                                                                                                                                      #
#                                                                                                                                                      #
#                     ##################################################################################################################################
#                                                                                                                                                      #
#                                                                                                                                                      #
#                                                               ^                                                                                      #
#                                                                                                                                                      #
#                                                                                                                                                      #
#                                                                                                                                                      #
#                                                                                                                                                      #
#                                                                                                                                                      #
#                                                                                                                                                      #
#                                                                                                                                                      #
#                                                                                                                                                      #
#                                                                                                                                                      #
#                                                                                                                                                      #
#                                                                                                                                                      #
#                                                                                                                                                      #
#                                                                                                                                                      #
#                                                                                                                                                      #
########################################################################################################################################################
